---------------------------------------
  -     - -----------------------------
  -  -  -  -  -  -  ------ - - - - - --                                    -
  -  -  -------------------------------
     -                                -
-----------------------------------  --
------------------------------------*--